         12221
        1000001
        1001001
  1 1   2001002   1 1
  1 1  120010021  1 1
 211111000010000111112
 200000010000010000002
 200000010000010000002
 111112200000002211111
        1100011
       11 111 11